##########################
#........................#
#....#....#....#....#....#
#........................#
#.....####################
#.....#...........#
#.....#....   ....#
#..........   ....#
#.................#
###################