##########################
#........................#
#....#....#....#....#....#
#........................#
#.....####################
#.....#.............#
#.....#....   ....###
#..........   ....#
#.................#
###################